#########################################
#                                       #
#             ###########               #
#          #!!###########!!#            #
#         A                 L           #
#         1                   #         #
#        #                    #         #
#       #                     #         #
#      #    \\\\     \\\\     #         #
#      #          !          #          #
#        #         @@        #          #
#         #                 #           #
#          ##     **R**     #           #
#        ... ##            #....        #
# ..........  ########W####  .........  #
#..........B              ............. #
#..\.........2          ...........\....#
#########################################
                                         
    # #  #  #  ###  ###   ##   #.  #
    ###  #  #   #    #   #  #  # . #
    # #   ##    #    #    ##   #  .#

Trampoline A targets 2
Trampoline B targets 1
Growth 5
Razors 33
